key BEEJ: YGAE
key BEIF: YGEA
key BEIT: YGEO
key BESJ: YGOE
key BEIX: YGES
key BEWJ: YGSE
key BEET: YGAO
key BESF: YGOA
key BEEX: YGAS
key BEWF: YGSA
key BEIW: YGER
key BEVJ: YGRE
key BEIR: YGEN
key BEQJ: YGNE
key BEEW: YGAR
key BEVF: YGRA
key BEIN: YGEI
key BEMJ: YGIE
key BEER: YGAN
key BEQF: YGNA
key BEHJ: YGDE
key BEII: YGED
key BEEN: YGAI
key BEMF: YGIA
key BEEI: YGAD
key BEHF: YGDA
key BESX: YGOS
key BEWT: YGSO
key BEIP: YGEL
key BEOJ: YGLE
key BEFJ: YGBE
key BEIG: YGEB
key BEIY: YGET
key BEXJ: YGTE
key BEEP: YGAL
key BEOF: YGLA
key BESW: YGOR
key BEVT: YGRO
key BEEG: YGAB
key BEFF: YGBA
key BEQT: YGNO
key BESR: YGON
key BEEY: YGAT
key BEXF: YGTA
key BEVX: YGRS
key BEWW: YGSR
key BEMT: YGIO
key BESN: YGOI
key BEIZ: YGEU
key BEYJ: YGUE
key BEQX: YGNS
key BEWR: YGSN
key BEHT: YGDO
key BESI: YGOD
key BEMX: YGIS
key BEWN: YGSI
key BEEZ: YGAU
key BEYF: YGUA
key BEIJ: YGEE
key BEHX: YGDS
key BEWI: YGSD
key BEQW: YGNR
key BEVR: YGRN
key BEOT: YGLO
key BESP: YGOL
key BEIQ: YGEM
key BEPJ: YGME
key BEMW: YGIR
key BEVN: YGRI
key BEMR: YGIN
key BEQN: YGNI
key BEFT: YGBO
key BESG: YGOB
key BEHW: YGDR
key BEVI: YGRD
key BESY: YGOT
key BEXT: YGTO
key BEOX: YGLS
key BEWP: YGSL
key BEEQ: YGAM
key BEPF: YGMA
key BEHR: YGDN
key BEQI: YGND
key BEEF: YGAA
key BEFX: YGBS
key BEWG: YGSB
key BEWY: YGST
key BEXX: YGTS
key BEHN: YGDI
key BEMI: YGID
key BEIU: YGEP
key BETJ: YGPE
key BEOW: YGLR
key BEVP: YGRL
key BESZ: YGOU
key BEYT: YGUO
key BEOR: YGLN
key BEQP: YGNL
key BEFW: YGBR
key BEVG: YGRB
key BEVY: YGRT
key BEXW: YGTR
key BEEU: YGAP
key BETF: YGPA
key BEFR: YGBN
key BEQG: YGNB
key BEWZ: YGSU
key BEYX: YGUS
key BEQY: YGNT
key BEXR: YGTN
key BEMP: YGIL
key BEON: YGLI
key BEFN: YGBI
key BEMG: YGIB
key BEHP: YGDL
key BEOI: YGLD
key BEMY: YGIT
key BEXN: YGTI
key BEFI: YGBD
key BEHG: YGDB
key BEPT: YGMO
key BESQ: YGOM
key BEHY: YGDT
key BEXI: YGTD
key BEVZ: YGRU
key BEYW: YGUR
key BEQZ: YGNU
key BEYR: YGUN
key BEPX: YGMS
key BEWQ: YGSM
key BEMZ: YGIU
key BEYN: YGUI
key BEFP: YGBL
key BEOG: YGLB
key BEHZ: YGDU
key BEYI: YGUD
key BEOY: YGLT
key BEXP: YGTL
key BESU: YGOP
key BETT: YGPO
key BEFY: YGBT
key BEXG: YGTB
key BEPW: YGMR
key BEVQ: YGRM
key BEPR: YGMN
key BEQQ: YGNM
key BETX: YGPS
key BEWU: YGSP
key BEMQ: YGIM
key BEPN: YGMI
key BEOZ: YGLU
key BEYP: YGUL
key BEST: YGOO
key BEHQ: YGDM
key BEPI: YGMD
key BEFZ: YGBU
key BEYG: YGUB
key BEXZ: YGTU
key BEYY: YGUT
key BETW: YGPR
key BEVU: YGRP
key BEQU: YGNP
key BETR: YGPN
key BEWX: YGSS
key BEMU: YGIP
key BETN: YGPI
key BEOQ: YGLM
key BEPP: YGML
key BEFQ: YGBM
key BEPG: YGMB
key BEHU: YGDP
key BETI: YGPD
key BEPY: YGMT
key BEXQ: YGTM
key BEOU: YGLP
key BETP: YGPL
key BEPZ: YGMU
key BEYQ: YGUM
key BEIA: YGEV
key BEZJ: YGVE
key BEIV: YGEQ
key BEUJ: YGQE
key BEVW: YGRR
key BEFU: YGBP
key BETG: YGPB
key BETY: YGPT
key BEXU: YGTP
key BEEA: YGAV
key BEZF: YGVA
key BEQR: YGNN
key BEEV: YGAQ
key BEUF: YGQA
key BETZ: YGPU
key BEYU: YGUP
key BEMN: YGII
key BEIM: YGEH
key BELJ: YGHE
key BEIK: YGEF
key BEJJ: YGFE
key BEEM: YGAH
key BELF: YGHA
key BEEK: YGAF
key BEJF: YGFA
key BEHI: YGDD
key BEPU: YGMP
key BETQ: YGPM
key BESA: YGOV
key BEZT: YGVO
key BESV: YGOQ
key BEUT: YGQO
key BEWA: YGSV
key BEZX: YGVS
key BEDJ: YGZE
key BEIE: YGEZ
key BEUX: YGQS
key BEWV: YGSQ
key BEDF: YGZA
key BEEE: YGAZ
key BEVA: YGRV
key BEZW: YGVR
key BEOP: YGLL
key BELT: YGHO
key BESM: YGOH
key BEUW: YGQR
key BEVV: YGRQ
key BEQA: YGNV
key BEZR: YGVN
key BEIÑ: YGEJ
key BENJ: YGJE
key BEJT: YGFO
key BESK: YGOF
key BEQV: YGNQ
key BEUR: YGQN
key BEMA: YGIV
key BEZN: YGVI
key BELX: YGHS
key BEWM: YGSH
key BEEÑ: YGAJ
key BENF: YGJA
key BEJX: YGFS
key BEWK: YGSF
key BEMV: YGIQ
key BEUN: YGQI
key BEFG: YGBB
key BEXY: YGTT
key BEHA: YGDV
key BEZI: YGVD
key BEHV: YGDQ
key BEUI: YGQD
key BELW: YGHR
key BEVM: YGRH
key BEJW: YGFR
key BEVK: YGRF
key BELR: YGHN
key BEQM: YGNH
key BEJR: YGFN
key BEQK: YGNF
key BEDT: YGZO
key BESE: YGOZ
key BEOA: YGLV
key BEZP: YGVL
key BELN: YGHI
key BEMM: YGIH
key BEOV: YGLQ
key BEUP: YGQL
key BEJN: YGFI
key BEMK: YGIF
key BEIS: YGEÑ
key BERJ: YGÑE
key BEFA: YGBV
key BEZG: YGVB
key BEXA: YGTV
key BEZY: YGVT
key BEDX: YGZS
key BEWE: YGSZ
key BEFV: YGBQ
key BEUG: YGQB
key BEHM: YGDH
key BELI: YGHD
key BEUY: YGQT
key BEXV: YGTQ
key BEHK: YGDF
key BEJI: YGFD
key BEES: YGAÑ
key BERF: YGÑA
key BEYZ: YGUU
key BENT: YGJO
key BESÑ: YGOJ
key BEDW: YGZR
key BEVE: YGRZ
key BEYA: YGUV
key BEZZ: YGVU
key BENX: YGJS
key BEWÑ: YGSJ
key BEDR: YGZN
key BEQE: YGNZ
key BELP: YGHL
key BEOM: YGLH
key BEUZ: YGQU
key BEYV: YGUQ
key BEIL: YGEG
key BEKJ: YGGE
key BEJP: YGFL
key BEOK: YGLF
key BEFM: YGBH
key BELG: YGHB
key BEDN: YGZI
key BEME: YGIZ
key BELY: YGHT
key BEXM: YGTH
key BEFK: YGBF
key BEJG: YGFB
key BEJY: YGFT
key BEXK: YGTF
key BEEL: YGAG
key BEKF: YGGA
key BECJ: YGYE
key BEID: YGEY
key BEDI: YGZD
key BEHE: YGDZ
key BENW: YGJR
key BEVÑ: YGRJ
key BEBJ: YGXE
key BEIC: YGEX
key BENR: YGJN
key BEQÑ: YGNJ
key BEPA: YGMV
key BEZQ: YGVM
key BECF: YGYA
key BEED: YGAY
key BEPV: YGMQ
key BEUQ: YGQM
key BEBF: YGXA
key BEEC: YGAX
key BELZ: YGHU
key BEYM: YGUH
key BEMÑ: YGIJ
key BENN: YGJI
key BEJZ: YGFU
key BEYK: YGUF
key BERT: YGÑO
key BESS: YGOÑ
key BEDP: YGZL
key BEOE: YGLZ
key BEHÑ: YGDJ
key BENI: YGJD
key BEPQ: YGMM
key BERX: YGÑS
key BEWS: YGSÑ
key BEDG: YGZB
key BEFE: YGBZ
key BEDY: YGZT
key BEXE: YGTZ
key BETA: YGPV
key BEZU: YGVP
key BETV: YGPQ
key BEUU: YGQP
key BELQ: YGHM
key BEPM: YGMH
key BEKT: YGGO
key BESL: YGOG
key BENP: YGJL
key BEOÑ: YGLJ
key BEJQ: YGFM
key BEPK: YGMF
key BERW: YGÑR
key BEVS: YGRÑ
key BEQS: YGNÑ
key BERR: YGÑN
key BEFÑ: YGBJ
key BENG: YGJB
key BEDZ: YGZU
key BEYE: YGUZ
key BENY: YGJT
key BEXÑ: YGTJ
key BEKX: YGGS
key BEWL: YGSG
key BECT: YGYO
key BESD: YGOY
key BEMS: YGIÑ
key BERN: YGÑI
key BEBT: YGXO
key BESC: YGOX
key BEHS: YGDÑ
key BERI: YGÑD
key BECX: YGYS
key BEWD: YGSY
key BELU: YGHP
key BETM: YGPH
key BEBX: YGXS
key BEWC: YGSX
key BEKW: YGGR
key BEVL: YGRG
key BEJU: YGFP
key BETK: YGPF
key BENZ: YGJU
key BEYÑ: YGUJ
key BEKR: YGGN
key BEQL: YGNG
key BEDQ: YGZM
key BEPE: YGMZ
key BEKN: YGGI
key BEML: YGIG
key BETU: YGPP
key BECW: YGYR
key BEVD: YGRY
key BEOS: YGLÑ
key BERP: YGÑL
key BEBW: YGXR
key BEVC: YGRX
key BECR: YGYN
key BEQD: YGNY
key BEHL: YGDG
key BEKI: YGGD
key BEBR: YGXN
key BEQC: YGNX
key BEFS: YGBÑ
key BERG: YGÑB
key BERY: YGÑT
key BEXS: YGTÑ
key BECN: YGYI
key BEMD: YGIY
key BENQ: YGJM
key BEPÑ: YGMJ
key BEBN: YGXI
key BEMC: YGIX
key BECI: YGYD
key BEHD: YGDY
key BEDU: YGZP
key BETE: YGPZ
key BEBI: YGXD
key BEHC: YGDX
key BEKP: YGGL
key BEOL: YGLG
key BERZ: YGÑU
key BEYS: YGUÑ
key BEFL: YGBG
key BEKG: YGGB
key BEKY: YGGT
key BEXL: YGTG
key BECP: YGYL
key BEOD: YGLY
key BENU: YGJP
key BETÑ: YGPJ
key BEBP: YGXL
key BEOC: YGLX
key BECG: YGYB
key BEFD: YGBY
key BECY: YGYT
key BEXD: YGTY
key BEBG: YGXB
key BEFC: YGBX
key BEBY: YGXT
key BEXC: YGTX
key BEKZ: YGGU
key BEYL: YGUG
key BEPS: YGMÑ
key BERQ: YGÑM
key BECZ: YGYU
key BEYD: YGUY
key BEBZ: YGXU
key BEYC: YGUX
key BEKQ: YGGM
key BEPL: YGMG
key BEUA: YGQV
key BEZV: YGVQ
key BERU: YGÑP
key BETS: YGPÑ
key BECQ: YGYM
key BEPD: YGMY
key BEBQ: YGXM
key BEPC: YGMX
key BEKU: YGGP
key BETL: YGPG
key BELA: YGHV
key BEZM: YGVH
key BEJA: YGFV
key BEZK: YGVF
key BELV: YGHQ
key BEUM: YGQH
key BEJV: YGFQ
key BEUK: YGQF
key BECU: YGYP
key BETD: YGPY
key BEBU: YGXP
key BETC: YGPX
key BEJM: YGFH
key BELK: YGHF
key BEDA: YGZV
key BEZE: YGVZ
key BEDV: YGZQ
key BEUE: YGQZ
key BENA: YGJV
key BEZÑ: YGVJ
key BENV: YGJQ
key BEUÑ: YGQJ
key BEDM: YGZH
key BELE: YGHZ
key BEDK: YGZF
key BEJE: YGFZ
key BELÑ: YGHJ
key BENM: YGJH
key BEJÑ: YGFJ
key BENK: YGJF
key BERA: YGÑV
key BEZS: YGVÑ
key BEIO: YGEK
key BEÑJ: YGKE
key BERV: YGÑQ
key BEUS: YGQÑ
key BEEO: YGAK
key BEÑF: YGKA
key BEDÑ: YGZJ
key BENE: YGJZ
key BEKA: YGGV
key BEZL: YGVG
key BEKV: YGGQ
key BEUL: YGQG
key BELS: YGHÑ
key BERM: YGÑH
key BEJS: YGFÑ
key BERK: YGÑF
key BECA: YGYV
key BEZA: YGVV
key BEZD: YGVY
key BEBA: YGXV
key BECV: YGYQ
key BEUD: YGQY
key BEZC: YGVX
key BEBV: YGXQ
key BEUC: YGQX
key BEUV: YGQQ
key BEKM: YGGH
key BELL: YGHG
key BEJL: YGFG
key BEKK: YGGF
key BEÑT: YGKO
key BESO: YGOK
key BEDS: YGZÑ
key BERE: YGÑZ
key BEÑX: YGKS
key BEWO: YGSK
key BECM: YGYH
key BELD: YGHY
key BECK: YGYF
key BEJD: YGFY
key BEBM: YGXH
key BELC: YGHX
key BEBK: YGXF
key BEJC: YGFX
key BEÑW: YGKR
key BEVO: YGRK
key BEAJ: YGWE
key BEGJ: YGCE
key BEIB: YGEW
key BEIH: YGEC
key BENS: YGJÑ
key BERÑ: YGÑJ
key BEÑR: YGKN
key BEQO: YGNK
key BEDL: YGZG
key BEKE: YGGZ
key BEAF: YGWA
key BEEB: YGAW
key BEEH: YGAC
key BEGF: YGCA
key BEMO: YGIK
key BEÑN: YGKI
key BELM: YGHH
key BEJK: YGFF
key BEHO: YGDK
key BEÑI: YGKD
key BECE: YGYZ
key BEDD: YGZY
key BEBE: YGXZ
key BEDC: YGZX
key BEKÑ: YGGJ
key BENL: YGJG
key BEÑP: YGKL
key BEOO: YGLK
key BECÑ: YGYJ
key BEND: YGJY
key BEBÑ: YGXJ
key BENC: YGJX
key BEFO: YGBK
key BEÑG: YGKB
key BEÑY: YGKT
key BEXO: YGTK
key BEAT: YGWO
key BEGT: YGCO
key BESB: YGOW
key BESH: YGOC
key BEAX: YGWS
key BEGX: YGCS
key BEWB: YGSW
key BEWH: YGSC
key BEÑZ: YGKU
key BEYO: YGUK
key BEKS: YGGÑ
key BERL: YGÑG
key BECS: YGYÑ
key BERD: YGÑY
key BEAW: YGWR
key BEGW: YGCR
key BEVB: YGRW
key BEVH: YGRC
key BEBS: YGXÑ
key BERC: YGÑX
key BEDE: YGZZ
key BEAR: YGWN
key BEGR: YGCN
key BEQB: YGNW
key BEQH: YGNC
key BEÑQ: YGKM
key BEPO: YGMK
key BEAN: YGWI
key BEGN: YGCI
key BEMB: YGIW
key BEMH: YGIC
key BEAI: YGWD
key BEGI: YGCD
key BEHB: YGDW
key BEHH: YGDC
key BECL: YGYG
key BEKD: YGGY
key BEBL: YGXG
key BEKC: YGGX
key BEÑU: YGKP
key BETO: YGPK
key BEAP: YGWL
key BEGP: YGCL
key BEOB: YGLW
key BEOH: YGLC
key BEBD: YGXY
key BECC: YGYX
key BENÑ: YGJJ
key BEAG: YGWB
key BEFB: YGBW
key BEFH: YGBC
key BEGG: YGCB
key BEAY: YGWT
key BEGY: YGCT
key BEXB: YGTW
key BEXH: YGTC
key BEAZ: YGWU
key BEGZ: YGCU
key BEYB: YGUW
key BEYH: YGUC
key BEKL: YGGG
key BEAQ: YGWM
key BEGQ: YGCM
key BEPB: YGMW
key BEPH: YGMC
key BECD: YGYY
key BEAU: YGWP
key BEGU: YGCP
key BETB: YGPW
key BETH: YGPC
key BERS: YGÑÑ
key BEÑA: YGKV
key BEZO: YGVK
key BEÑV: YGKQ
key BEUO: YGQK
key BELO: YGHK
key BEÑM: YGKH
key BEJO: YGFK
key BEÑK: YGKF
key BEBC: YGXX
key BEDO: YGZK
key BEÑE: YGKZ
key BEAA: YGWV
key BEGA: YGCV
key BEZB: YGVW
key BEZH: YGVC
key BEAV: YGWQ
key BEGV: YGCQ
key BENO: YGJK
key BEÑÑ: YGKJ
key BEUB: YGQW
key BEUH: YGQC
key BEAM: YGWH
key BEGM: YGCH
key BELB: YGHW
key BELH: YGHC
key BEAK: YGWF
key BEGK: YGCF
key BEJB: YGFW
key BEJH: YGFC
key BEÑS: YGKÑ
key BERO: YGÑK
key BEAE: YGWZ
key BEDB: YGZW
key BEDH: YGZC
key BEGE: YGCZ
key BEKO: YGGK
key BEÑL: YGKG
key BECO: YGYK
key BEÑD: YGKY
key BEAÑ: YGWJ
key BEBO: YGXK
key BEGÑ: YGCJ
key BENB: YGJW
key BENH: YGJC
key BEÑC: YGKX
key BEAS: YGWÑ
key BEGS: YGCÑ
key BERB: YGÑW
key BERH: YGÑC
key BEAL: YGWG
key BEGL: YGCG
key BEKB: YGGW
key BEKH: YGGC
key BEAD: YGWY
key BECB: YGYW
key BECH: YGYC
key BEGD: YGCY
key BEAC: YGWX
key BEBB: YGXW
key BEBH: YGXC
key BEGC: YGCX
key BEAO: YGWK
key BEGO: YGCK
key BEÑB: YGKW
key BEÑH: YGKC
key BEAH: YGWC
key BEGB: YGCW
key BEÑO: YGKK
key BEAB: YGWW
key BEGH: YGCC
